9 6
4 5
3 6 5 3 6 5 3 5 4
4 8 8 8 8 8 8 8 7
2 8 1 3 6 5 1 8 2
4 8 1 3 5 4 1 8 4
7 8 8 8 8 7 4 8 7
2 3 5 1 8 2 2 8 2
7 5 3